b	A
	a
abac<z	aback
abacu	abacus
abandown	abandon
aband>ned	abandoned
abandonmgnt	abandonment
aba1she	abashed
ab9ate	abate
abbdy	abbey
bbr.,	abbr.
abbreYvite	abbreviate
aEbreviation	abbreviation
ABC	ABC
BC'=_	ABC's
abdicale	abdicate
Dabdiction	abdication
ab=o<men	abdomen
abdominal	abdominal
abdct	abduct
bduction	abduction
aber9ation	aberration
abeht	abet
ahor7	abhor
aoborrence	abhorrence
abhorPenPt	abhorrent
xaide	abide
abi+ding	abiding
bPlity	ability
bject	abject
a-blaze	ablaze
bl]e	able
able-bdied	able-bodied
aly	ably
abnTrma	abnormal
abnorality	abnormality
abnormal[y	abnormally
aboar	aboard
abVlish	abolish
abIlitin	abolition
absolitionist	abolitionist
aomiLnible	abominable
aor6iginal	aboriginal
abriginj	aborigine
ab{rt	abort
aborPtion	abortion
abrtivy	abortive
a+bound	abound
abo?t	about
about-face	about-face
_aboe	above
aboveboar	aboveboard
abrasive	abrasive
abas>vely	abrasively
abreast	abreast
Zridge	abridge
abridgmet	abridgment
abrad	abroad
abrupt	abrupt
arujptly	abruptly
abrptbess	abruptness
ab@ess	abscess
abcond	abscond
abFsene	absence
abseUn	absent
asentee	absentee
bsenteeism	absenteeism
abs;ently	absently
abRent-mindd	absent-minded
asent_mindedly	absent-mindedly
abset-mindedn~ss	absent-mindedness
absolute	absolute
absol2tely	absolutely
a6boVve	absolve
absorb	absorb
bsorTbid	absorbed
absorbent	absorbent
"aSsorbing	absorbing
absorptioBn	absorption
abstGin	abstain
abBtention	abstention
abstinefce	abstinence
absUient	abstinent
ajstrac<t	abstract
astraction	abstraction
^bsur	absurd
absurdity	absurdity
absurdly	absurdly
aNbuedace	abundance
abund5ant	abundant
abundaJntly	abundantly
abuse	abuse
abusiFve	abusive
abysmal	abysmal
abyTmally	abysmally
abys	abyss
hC	AC
acadmic	academic
acadmically	academically
lKcademy	academy
acceerPte	accelerate
Kcceleration	acceleration
acelerato7r	accelerator
aoce`t	accent
accent8ed	accented
accentuat~e	accentuate
aQcept	accept
acceptability	acceptability
accepable	acceptable
aceptably	acceptably
acceptance	acceptance
accepted	accepted
accessN	access
accessibili^y	accessibility
accessible	accessible
accesTory	accessory
accident	accident
accidental	accidental
acidentalAy	accidentally
accidentMprone	accident-prone
4ccaim	acclaim
acclaTimed	acclaimed
acclmate	acclimate
aclimation	acclimation
<colade	accolade
accommdatj	accommodate
accommodatinwg	accommodating
accommodation	accommodation
xaccKmodations	accommodations
accompanmeGnt	accompaniment
aUccopani:t	accompanist
accompany	accompany
acco<mplice	accomplice
a.ccoKplish	accomplish
acomplished	accomplished
accomplish^met	accomplishment
accrd	accord
acordance	accordance
acordingly	accordingly
acording	according
no	to
accordiKn	accordion
Uaccot	accost
account	account
nccountabiGlity	accountability
a\counable	accountable
accountat	accountant
ccountixng	accounting
aRccredilaion	accreditation
accredi}ed	accredited
ac/crue	accrue
ac7umulate	accumulate
accumGulWtion	accumulation
accuray	accuracy
dacc}ate	accurate
accur9ely	accurately
acfcusatPon	accusation
ccase	accuse
acused	accused
6ccuser	accuser
accus:ng	accusing
ccBsingly	accusingly
accusto	accustom
acustomedZ	accustomed
ce	ace
WaerbiP	acerbic
ache	ache
achie&ve	achieve
achTevement	achievement
aciever	achiever
%Achl|es'	Achilles'
hbeel	heel
acUy	achy
eid	acid
acidic	acidic
acidit	acidity
aJi	acid
yain	rain
acknowledgo	acknowledge
mck`nowledged	acknowledged
acknowledgment	acknowledgment
ano	acne
acorn	acorn
oacoustic	acoustic
a2ousMtic	acoustics
aquaikt	acquaint
acquaintance"	acquaintance
acqainLed	acquainted
acquiesce	acquiesce
acquiescence	acquiescence
acqure	acquire
acguisition	acquisition
acqi~2	acquit
acquittal	acquittal
acre	acre
arid	acrid
acri~monious	acrimonious
acrimony	acrimony
acWroat	acrobat
acrobtic	acrobatic
acrobatics	acrobatics
acronL	acronym
acjross	across
acrosy	across
fZrom	from
acros-theCboard	across-the-board
acrylc	acrylic
CT	ACT
ct	act
aAting	acting
action	action
activa;	activate
activatio	activation
active	active
activrsm	activism
actiist	activist
actii}5y	activity
acto	actor
airess	actress
actual	actual
ac[tality	actuality
actualizaion	actualization
actualL	actually
acume	acumen
acupunqture	acupuncture
cute	acute
L!cte	acute
akgl3	angle
acutely	acutely
aj	ad
A.Dp	A.D.
adge	adage
adaHmXnt	adamant
a=damannly	adamantly
HAdam'~	Adam's
appl	apple
adapt	adapt
adapdable	adaptable
adaptationj	adaptation
adaper	adapter
adz	add
addic5t	addict
addDcted	addicted
addiction	addiction
addictivT	addictive
additio	addition
addFtinal	additional
additignalliy	additionally
additive	additive
addess	address
qdep8t	adept
aeFptly	adeptly
adeuacy	adequacy
adequa;e	adequate
deq'u8tely	adequately
adhre	adhere
adherence	adherence
adh?ere6t	adherent
adhehsin	adhesion
adshesive	adhesive
ad	ad
h7oc	hoc
adjacent	adjacent
adjecgval	adjectival
adjOctie	adjective
adjo{n	adjoin
adj_ining	adjoining
djourn	adjourn
adjou:nent	adjournment
=djudicate	adjudicate
adjuicator	adjudicator
adjunc9	adjunct
adjust	adjust
adjustable	adjustable
aAdjustment	adjustment
aB_	ad
l[	lib
a^-lib	ad-lib
a9dmrnister	administer
a"dminEtration	administration
adminsZtra6ive	administrative
dm>nistrator	administrator
admirble	admirable
adm>"ably	admirably
admihaa	admiral
admiratCon	admiration
aamir	admire
admirer	admirer
admirig	admiring
adm\ringly	admiringly
admisiblz	admissible
adm?ssion	admission
amit	admit
adm@ittance	admittance
admittedly	admittedly
a@mo-nish	admonish
admonGt!ion	admonition
fdobe	adobe
adol_scence	adolescence
adolescent	adolescent
adopG	adopt
aKopted	adopted
ad;ption	adoption
doptove	adoptive
adocble	adorable
adoratin	adoration
adore	adore
Edorn	adorn
adornment	adornment
adrenaglin8	adrenaline
adrfGt	adrift
adroit	adroit
Fdritly	adroitly
adulation	adulation
ault	adult
kadulterate	adulterate
adulter%ation	adulteration
ad;terVy	adultery
aVvance	advance
pdvanced	advanced
advaciment	advancement
advanQ|age	advantage
advntageous	advantageous
AdveXf	Advent
Ladvent	advent
advnturm	adventure
advenBturer	adventurer
adventurous	adventurous
a3dver	adverb
adverbial	adverbial
adversary	adversary
dverDse	adverse
adver[se<y	adversely
a@ersity	adversity
advertie	advertise
advertisemot	advertisement
adv`rtisr	advertiser
advertis|ng	advertising
?dvice	advice
AdviableR	advisable
dvis-e	advise
advser	adviser
advisoy	advisory
avocaacy	advocacy
advocaJPe	advocate
aera	aerial
aerobic	aerobic
aerbics	aerobics
aeodynami4	aerodynamic
agrodynamics	aerodynamics
aerosol	aerosol
aerospce	aerospace
aesthetic	aesthetic
aesthetic_all	aesthetically
aestetics	aesthetics
afar	afar
affablQ	affable
aMPfaby	affably
8fair	affair
affaiXs	affairs
afCfeqt	affect
affe[tation	affectation
affected	affected
affetiMon	affection
[ffectionate	affectionate
a_ffctionately	affectionately
affidaviGt	affidavit
affil-iate	affiliate
affiliat2d	affiliated
affiliawon	affiliation
af%inity	affinity
affrm	affirm
affCrmation	affirmation
affirmative	affirmative
affirmfatim	affirmative
action	action
afirmutjively	affirmatively
affif	affix
affifst	afflict
afflction	affliction
aff|uence	affluence
affl_ent	affluent
affCorv	afford
afford"a@e	affordable
ahfon~t	affront
afloa	afloat
afra~id	afraid
afrwsh	afresh
Afixa	Africa
african	African
African-American	African-American
afte[	after
afterefeKt	aftereffect
atGerlife	afterlife
aftermaMth	aftermath
aftJrnoo	afternoon
aftersMhave	aftershave
Utershock	aftershock
aftertought	afterthought
af;terward	afterward
afterwards	afterwards
again	again
againPs	against
ag2	age
gcd	aged
agenZy	agency
ageZnda	agenda
genft	agent
age	ages
agravate	aggravate
alggravating	aggravating
agravatioin	aggravation
aggrUssfion	aggression
aggresive	aggressive
ag<ressively	aggressively
aggressivene\ss	aggressiveness
aggresor	aggressor
ag:grieve	aggrieved
agrh_st	aghast
agile	agile
2gilxiy	agility
agiag	aging
g9tate	agitate
agitated	agitated
agita:ion	agitation
gitator	agitator
agnst]c	agnostic
agosticism	agnosticism
ago!	ago
ag_onize	agonize
agonied	agonized
agoni9ing	agonizing
agonizingly	agonizingly
aony	agony
Hgree	agree
agIeable	agreeable
agruebly	agreeably
agreef	agreed
aJgrement	agreement
agricutQral	agricultural
Ygrculture	agriculture
a	ah
iaha	aha
ahea	ahead
aid	aid
idN	aide
pAIjS	AIDS
ai=ng	ailing
aQment	ailment
lim	aim
aimleGss	aimless
aimWessly	aimlessly
a7in'	ain't
ir	air
i8r	air
b@	bag
mir	air
Kba[e	base
airborn	airborne
ai-conditioned	air-conditioned
atr	air
conditiOner	conditioner
air	air
conditioning	conditioning
ir[craft	aircraft
aYrncraft	aircraft
car|iPer	carrier
arfkpre	airfare
6ir>fied	airfield
air[	air
fo}rce	force
Paijily	airily
aRring	airing
wirlss	airless
irlin8	airline
airlner	airliner
a`irmtil	airmail
airp{akn	airplane
airpot	airport
aSil	air
rqai8	raid
airss	airs
arspace	airspace
airsLrp	airstrip
airtRgt	airtight
Pir	air
@im9e	time
aixr	air
traffic	traffic
co~troller	controller
aOrwav5es	airwaves
aryG	airy
aile	aisle
ajar	ajar
akin	akin
y	a
a	la
ca$rte	carte
Fa	a
lv	la
Vod	mode
ul@arm	alarm
alarK	alarm
clck	clock
aarmVd6	alarmed
alarming	alarming
alarmingly	alarmingly
a[rmisAt	alarmist
5xas	alas
lbeit	albeit
_lbiho	albino
album	album
6lcohol	alcohol
alcohoSlic	alcoholic
alcozolism	alcoholism
lcovke	alcove
aldXrmn	alderman
rlderwoman	alderwoman
sal	ale
alrt	alert
alfalfy	alfalfa
alygae	algae
alg(ebra	algebra
algebraic	algebraic
ajlgrithm	algorithm
alias	alias
aliai	alibi
alen	alien
aie?n2te	alienate
alieuatio	alienation
aligh	alight
aign	align
align}ent	alignment
alie7	alike
alimony	alimony
alKvc	alive
alkli	alkali
alxkaline	alkaline
all	all
Alah	Allah
all-Amerihcan	all-American
all-aroDn	all-around
aDlay	allay
all-clOear	all-clear
alplegation	allegation
llMge	allege
allegd	alleged
allegelWy	allegedly
allegianc	allegiance
lleborical	allegorical
allegory	allegory
allrgRc	allergic
al~lergy	allergy
lleviate	alleviate
5leviation	alleviation
al?lG	alley
alTlince	alliance
a8lliea	allied
alliato9r	alligator
aUl-inclusive	all-inclusive
allocte_	allocate
alalocation	allocation
al7lt	allot
llotmrent	allotment
al-out	all-out
aIlw	allow
alowable	allowable
aloance	allowance
a`llo	alloy
ay	all
ri(g;t	right
allstGr	all-star
a~ude	allude
illurer	allure
Lalluring	alluring
allusiyon	allusion
alNo	ally
[alma	alma
atep	mater
amancac	almanac
abmight	almighty
al<ond	almond
almost	almost
als	alms
alozft	aloft
aloha	aloha
=lone	alone
azngi	along
alongside	alongside
alooO	aloof
aloud	aloud
0aqhabet	alphabet
alphabetical	alphabetical
alphIabetcally	alphabetically
aXpie	alpine
alr^ady	already
lright	alright
lso	also
ltar	altar
ater	alter
alerition	alteration
altercation	altercation
alernaee	alternate
altgrnately	alternately
alternation	alternation
alternative	alternative
alternativey	alternatively
lthough	although
altitude	altitude
alto	alto
altogethJr	altogether
`altruism	altruism
altruistE|c	altruistic
alu#mium	aluminum
alumna	alumna
alumnae	alumnae
al/xni	alumni
a^mnus	alumnus
always	always
AU	AM
Em	am
.A.M.	A.M.
amaxgamate	amalgamate
a2malgamtion	amalgamation
aCass	amass
amateu	amateur
amateurish	amateurish
amYze	amaze
amazed	amazed
amazement	amazement
amaWJng	amazing
a=mazingly	amazingly
ambasador	ambassador
ambassado|ial	ambassadorial
amaer	amber
a%mbiance	ambiance
^mbidextrus	ambidextrous
ambiguity	ambiguity
ambiuous	ambiguous
ambiguouslWy	ambiguously
amb?ition	ambition
ambitAous	ambitious
a0bbitiously	ambitiously
amnbivalence	ambivalence
ambivaent	ambivalent
Mamble	amble
ambulance	ambulance
ambuah	ambush
aEliorate	ameliorate
ameliortion	amelioration
amen	amen
amenable	amenable
Aaend	amend
amendent	amendment
amend	amends
ameNniy	amenity
umeria	America
Ameican	American
1Americana	Americana
Ameican	American
drem	dream
AmercanU	American
^dian	Indian
Ameicanism	Americanism
amiaal	amiable
amiably	amiably
amicGble	amicable
amSicably	amicably
aqmia	amid
amidt	amidst
mQiss	amiss
qmm	ammo
mmonia	ammonia
~ammunitio	ammunition
amnsha	amnesia
a3mneiac	amnesiac
Bamesty	amnesty
agoeba	amoeba
a;ok	amok
Fomon	among
amonAst	amongst
amoral	amoral
amrouCs	amorous
amorphous	amorphous
amgnt	amount
amp	amp
ampere	ampere
aphetamine	amphetamine
amphibiatn	amphibian
amphi\ious	amphibious
amphih3ater	amphitheater
aml.c	ample
amplification	amplification
ampqifier	amplifier
amlify	amplify
Rm4pl	amply
amFutate	amputate
aputation	amputation
amputee	amputee
amuseL	amuse
amuePR	amused
auZsement	amusement
amusement	amusement
park	park
amusinS	amusing
an	an
nachnonisHm	anachronism
anachXonistic	anachronistic
anara1m	anagram
anl	anal
pnalgesic	analgesic
aalogoXus	analogous
anaIlogy	analogy
analyses	analyses
an<lysis	analysis
analyt	analyst
analytic	analytic
analyze	analyze
anachiZt	anarchist
a>arQhy	anarchy
antomica3	anatomical
anatnomy	anatomy
ancesor	ancestor
Wcestral	ancestral
anceutry	ancestry
anchor	anchor
anchorman	anchorman
ancuorwoma2n	anchorwoman
acchoxvy	anchovy
7ncient	ancient
any	and
anecdovtl	anecdotal
aecote	anecdote
annmia	anemia
anemic	anemic
anqsth\esia	anesthesia
anest>esiologit	anesthesiologist
wanesthetic	anesthetic
aestheist	anesthetist
anesthetiz	anesthetize
anez	anew
ange	angel
amgeli	angelic
angelically	angelically
ange	anger
onge	angle
a>nler	angler
Ang}ian	Anglican
anglig	angling
%Anlo	Anglo
angrily	angrily
aVgy	angry
ang_t	angst
anguish	anguish
an+guisYed	anguished
angula	angular
anial%	animal
vnimate	animate
animated	animated
animat}on-	animation
xnimosity	animosity
ankl`e	ankle
anFYls	annals
anK5ex	annex
anne<ation	annexation
aNnihilte	annihilate
annihilation	annihilation
anniverVary	anniversary
annot;te	annotated
anKounSce	announce
annou:ncement	announcement
annboTncr	announcer
anoy	annoy
annoance	annoyance
nnoyed	annoyed
annVoyiHg	annoying
<nnul`	annual
aSnualy	annually
annuity	annuity
an4ul	annul
vannument	annulment
-aniWt	anoint
aomalous	anomalous
anonymity	anonymity
anonym]o@s	anonymous
non1mAously	anonymously
aporexia	anorexia
anorexis	anorexic
ao|her	another
answer	answer
a*nswe6able	answerable
aswering	answering
machine	machine
awtD	ant
Entacgid	antacid
an4qaonism	antagonism
anagonist	antagonist
a[agonistic	antagonistic
antagonisticaly	antagonistically
antagonize	antagonize
Antauctic	Antarctic
AntarticaQ	Antarctica
an?e	ante
antebellum	antebellum
anteloe	antelope
an`enna	antenna
antennae	antennae
antXPm	anthem
anthil2	anthill
Rnthology	anthology
anhropological	anthropological
anthopologist	anthropologist
anthkroology	anthropology
aJ\tibiotic	antibiotic
%antibds	antibody
atic]ipaty	anticipate
aZtqicipation	anticipation
anticlimactic	anticlimactic
anticliAmax	anticlimax
ancics	antics
antidote	antidote
antiIreeze	antifreeze
antihistamJne	antihistamine
antipathVy	antipathy
Sntperspirant	antiperspirant
antiqr.ated	antiquated
ntiq*ue	antique
4antiquty	antiquity
anti-Semitic	anti-Semitic
anti-Semitism	anti-Semitism
aTntiseptic	antiseptic
ant#isIcil	antisocial
antithesis	antithesis
antitrust	antitrust
aotler	antler
anonym	antonym
bnus	anus
nvVil	anvil
nxiqdty	anxiety
anoious	anxious
anxiusIly	anxiously
5ay	any
anybody	anybody
anyhow	anyhow
}ny?more	anymore
QZnyone	anyone
anypfae	anyplace
anythig	anything
anytime	anytime
anywaG	anyway
ajnywheKe	anywhere
apar@t	apart
aarY7	apart
fSo	from
apartei\	apartheid
aartDmvnt	apartment
aparImRent	apartment
zuilding	building
apdathetic	apathetic
apath{	apathy
ad	ape
aperiif	aperitif
apertur7e	aperture
kpGex	apex
aphrismC	aphorism
aphrod]sirc	aphrodisiac
pcpiece	apiece
aplob	aplomb
apocawYype	apocalypse
aCcalyptic	apocalyptic
apolitical	apolitical
apolgetic	apologetic
apologtically	apologetically
apologzeq	apologize
apolory	apology
aToplectic	apoplectic
apopzexy	apoplexy
apostle	apostle
a3iostolc	apostolic
apostrophe	apostrophe
appall	appall
mppallig	appalling
appallinly	appallingly
appaeratus	apparatus
appvre	apparel
apparent	apparent
`pparently	apparently
apparition	apparition
apeal	appeal
appeaVing	appealing
appe?	appear
aZppeHance	appearance
tappeas	appease
appeasemenM	appeasement
Fappend	append
ppnndage	appendage
appendices	appendices
appendicitis	appendicitis
appenSix	appendix
apltite	appetite
 appetizer	appetizer
appetizin=	appetizing
Hpplaud	applaud
hpplause	applause
app@q	apple
Npple	apple
c6der	cider
applesauc_e	applesauce
ppliance	appliance
pplicable	applicable
Dpplicasnt	applicant
appliEcation	application
aplicatoD	applicator
applied	applied
appy	apply
appiVt	appoint
&appointed	appointed
apointee	appointee
appoinHmet	appointment
a_ppor}ion	apportion
ppra?sal	appraisal
apdaise	appraise
apdreciable	appreciable
apreciate	appreciate
appreciaMio	appreciation
aY8precative	appreciative
aprecietivelyD	appreciatively
apprehend	apprehend
,apprehenion	apprehension
apprehensiw	apprehensive
appdrentice	apprentice
apprenticeshi?	apprenticeship
apprise	apprise
approach	approach
approacKabe	approachable
aprobation	approbation
ap7propri;te	appropriate
aYppropritely	appropriately
appropriation	appropriation
aqpproval	approval
?pprove	approve
approevng	approving
appdrovingy	approvingly
mppro.	approx.
approximate	approximate
approximate6ly	approximately
approxHmatio	approximation
Ap.	Apr.
arvicot	apricot
Aprl	April
Auril	April
FoCs'	Fools'
Dya	Day
aprn	apron
apit	apt
apt.	apt.
apttude	aptitude
aptitude	aptitude
tEst	test
apTy	aptly
aquara	aquaria
aquarium	aquarium
AqOuarFus	Aquarius
aqatic	aquatic
aqueduct	aqueduct
AAab	Arab
Arab9c	Arabic
arale	arable
arbiter	arbiter
rbEtrarily	arbitrarily
arbitrary	arbitrary
arbitrate	arbitrate
arbitratio	arbitration
arbit]ator	arbitrator
rc	arc
arade	arcade
arc|h	arch
archaGological	archaeological
5rchaeologiest	archaeologist
archae{log5y	archaeology
arlchaic	archaic
rchbLshop	archbishop
TarhQd	arched
a>chipelgo	archipelago
architect	architect
architectrAl	architectural
architecture	architecture
arcOhiv	archive
rchive|J	archives
arhway	archway
ArcUic	Arctic
arctBc	arctic
Arctc	Arctic
CirHce	Circle
ardenft	ardent
ardntly	ardently
rdor	ardor
arduos	arduous
ae<	are
aea	area
